ABZSPJVXTTUFAA-UHFFFAOYSA-N	CC(=O)NC1=CC=C(C=C1)C(=O)NC2=C(C=CC(=C2)C3=CC=CS3)N
AHLSMWMHWYXLKD-UHFFFAOYSA-N	
BKYKAZAUMANNMI-FTBPSBKWSA-N	CC[C@H](C)C(=O)N[C@H](CC[C@H](CC1=CC=CC=C1)NC(=O)OCC2=CN=CS2)CC3=CC=CC=C3
BSQIVYOSLFLSGE-DYSKQJDISA-N	C[N+]1([C@@H]2CC(C[C@H]1[C@@H]3[C@H]2O3)OC(=O)[C@@H](CO)C4=CC=CC=C4)C.[N+](=O)([O-])[O-]
CLRSLRWKONPSRQ-IIPSPAQQSA-N	
DYDCUQKUCUHJBH-UHFFFAOYSA-N	C1C(C(=O)NO1)N
DYDCUQKUCUHJBH-UHFFFAOYSA-N	C1C(C(=NO1)[O-])[NH3+]
DYLGFOYVTXJFJP-MFKUBSTISA-N	CCCCN(CCCC)CC(C1=CC(=CC\2=C1C3=C(/C2=C\C4=CC=C(C=C4)Cl)C=C(C=C3)Cl)Cl)O
IHIXIJGXTJIKRB-UHFFFAOYSA-N	[O-][V](=O)([O-])[O-].[Na+].[Na+].[Na+]
IHIXIJGXTJIKRB-UHFFFAOYSA-N	[O-][V](=O)([O-])[O-].[Na+].[Na+].[Na+]
JARPJCKJRYKPQY-PUUVEUEGSA-N	
JGWRKYUXBBNENE-UHFFFAOYSA-N	C1=CC(=NC=C1CC2=CNC3=C2C=C(C=N3)Cl)NCC4=CN=C(C=C4)C(F)(F)F
JKDGKIBAOAFRPJ-ZBINZKHDSA-N	CC[C@H]1[C@H](NC(=O)[C@H]1F)COC2=NC=CC3=CC(=C(C=C32)OC)C(=O)N
KWRYMZHCQIOOEB-LBPRGKRZSA-N	C[C@@H](C1=C(N=C2C=C(C=CC2=C1)F)C3=CC=CC=N3)NC4=NC=NC5=C4NC=N5
LZCOQTDXKCNBEE-CTBOZYAPSA-N	C[N+]1([C@@H]2CC(C[C@H]1[C@@H]3[C@H]2O3)OC(=O)[C@@H](CO)C4=CC=CC=C4)C
QZDDHLKGAQQTLO-UHFFFAOYSA-N	CC1(CC(=O)C2=CC(=C(C=C2O1)Br)O)CCCC(C)(C)O
RJDAWNNBHDXTNY-UHFFFAOYSA-N	CC(=CC(=O)C1=CC(=C(C=C1O)Br)O)CCCC(C)(C)O
SOFCTBLAEJWBSR-PUUVEUEGSA-N	
SUQJOWRIFVHNKN-WFXMLNOXSA-N	CC[C@@H](CC[C@H](CC)NC(=O)OCC1=CN=CS1)NC(=O)[C@H](CO)NC(=O)N(C)CC2=CSC(=N2)C(C)C
VQOXZBDYSJBXMA-VHFLTRTASA-N	C[C@H]1/C=C/C=C/CC/C=C/C=C/C=C/C=C/[C@@H](C[C@H]2[C@@H]([C@H](C[C@](O2)(C[C@H]([C@@H](CC[C@H](C[C@H](C[C@H](CC(=O)O[C@H]([C@@H]([C@@H]1O)C)C)O)O)O)O)O)O)O)C(=O)O)O[C@@H]3[C@@H]([C@@H]([C@H]([C@@H](O3)C)O)N)O
WJDAHOMWAHFHLZ-SHXYBYRDSA-N	
XSEGWEUVSZRCBC-ZVBLRVHNSA-N	C[C@]12CC[C@H]3[C@H]([C@@H]1CC[C@@H]2O)C[C@H](C4=CC(=O)CC[C@]34C)O
YFUUQKJOCLQHMZ-ISJKLOBTSA-N	CC1=CC(=CC(=C1C[C@@H](C(=O)N(CC2=CC(=C(C=C2)OC)C(=O)O)[C@@H](C)C3=NC=C(N3)C4=CC=CC=C4)N)C)C(=O)N.Cl.Cl
YONKHGGSPJLWMP-UHFFFAOYSA-N	
ZKXZLIFRWWKZRY-KRWDZBQOSA-N	C1CN(CC2=CC=CC=C21)C[C@H](CNC(=O)C3=CC(=NC=N3)NC4COC4)O
ZVTDLPBHTSMEJZ-UPZRXNBOSA-N	CC(C)(C)OC(=O)N[C@@H]1CCCCC/C=C\[C@@H]2C[C@]2(NC(=O)[C@@H]3C[C@H](CN3C1=O)OC(=O)N4CC5=C(C4)C(=CC=C5)F)C(=O)NS(=O)(=O)C6CC6
ZYRLHJIMTROTBO-UHFFFAOYSA-N	C1=CC=C(C=C1)CSCCC(CCCCC(=O)O)SCC2=CC=CC=C2
